 ########### ##### ########### ######### 
#...........#.....#...........#.........#
#.#.###.#####.#.###.#####.###.#.#.#####.#
#.#...#.#...#.#.....#.#...#...#.#.#.#...#
#.###.###.#.#.#######.#.###.#####.#.#.## 
#...#.....#.#.#.....#.#.#.........#.#.#.#
 ##.#######.#.#.###.#.#.###########.#.#.#
#.#.#...#...#...#.....#...........#.#.#.#
#.#.###.#.#######.#######.#######.#.#.#.#
#.#.....#.........#.....#.......#.#.#.#.#
#.#####.###########.###.###.#####.#.#.#.#
#.....#.#...#.....#...#...#.#.....#...#.#
#.#.###.#.#.#.###.###.###.###.#####.###.#
#.#.......#.#...#.#...#.......#.....#...#
#.########## ##.#.#.## ##########.###.#.#
#.#.........#...#.#...#...#.....#.#...#.#
 ##.#######.#.###.#.#.#.#.#.###.#.#####.#
#...#...#.#.#.#.#.#.#.#.#.....#.#.......#
#.###.#.#.#.#.#.#.###.#.#######.#######.#
#.....#.#.#.#...#..D#.#.....#...#.......#
 ######.#.#.###.#####.#####.#.#####.#### 
#...#.#.#.#.#...#.......#.#.#.#...#.....#
#.#.#.#.#.#.#.#####.#.#.#.#.#.#.#.###### 
#.#.#.#...#...#...#.#.#...#.#...#.#.....#
#.#.#.###.#####.#.#.#.###.#.#####.#.###.#
#.#...#...#.....#.#.#.#...#...#...#.#.#.#
#.#####.#######.#.#.#.#####.###.###.#.#.#
#.#...#.#.......#.#.#...#...#...#.....#.#
#.#.#.#.###.#####.#####.#.###.#.#.#####.#
#...#...#...#...#.#...#...#...#.#.#.#...#
#.#######.###.#.#.#.#.###.#.#####.#.#.#.#
#.#.......#...#.#...#...#.#.#.....#.#.#.#
#.###.#####.#.#.#######.###.#.#####.#.#.#
#.....#...#.#.#.......#...#.........#.#.#
 ######.###.#.###########.###########.#.#
#...#.....#.#...........#.#...........#.#
#.#.#.###.#.###########.#.#.###########.#
#.#.#...#.#...#...#.....#...#...#.......#
#.#.###.#.###.#.#.#.#########.#.#.###### 
#O#.....#.......#.#...........#.........#
######## ####### # ########### ######### 
